..................******************..................
.................*..................*.................
................*....................*................
...............*......................*...............
..............*........................*..............
.............*..........................*.............
............*............................*............
...........*..............................*...........
..........*................................*..........
**********..................................**********
*....................................................*
*....................................................*
*....................................................*
*....................................................*
*....................................................*
*....................................................*
*....................................................*
******************************************************
.........*........*................*........*.........
.........*........*................*........*.........
.........*........*................*........*.........
.........*........*................*........*.........
.........*........*................*........*.........
.........*........*................*........*.........
.........*........*................*........*.........
.........**********................**********.........
