............................****************************............................
...........................*............................*...........................
..........................*..............................*..........................
.........................*................................*.........................
........................*..................................*........................
.......................*....................................*.......................
......................*......................................*......................
.....................*........................................*.....................
....................*..........................................*....................
...................*............................................*...................
..................*..............................................*..................
.................*................................................*.................
................*..................................................*................
...............*....................................................*...............
***************......................................................***************
*..................................................................................*
*..................................................................................*
*..................................................................................*
*..................................................................................*
*..................................................................................*
*..................................................................................*
*..................................................................................*
*..................................................................................*
*..................................................................................*
*..................................................................................*
*..................................................................................*
*..................................................................................*
************************************************************************************
..............*.............*..........................*.............*..............
..............*.............*..........................*.............*..............
..............*.............*..........................*.............*..............
..............*.............*..........................*.............*..............
..............*.............*..........................*.............*..............
..............*.............*..........................*.............*..............
..............*.............*..........................*.............*..............
..............*.............*..........................*.............*..............
..............*.............*..........................*.............*..............
..............*.............*..........................*.............*..............
..............*.............*..........................*.............*..............
..............*.............*..........................*.............*..............
..............***************..........................***************..............
