..............**************..............
.............*..............*.............
............*................*............
...........*..................*...........
..........*....................*..........
.........*......................*.........
........*........................*........
********..........................********
*........................................*
*........................................*
*........................................*
*........................................*
*........................................*
******************************************
.......*......*............*......*.......
.......*......*............*......*.......
.......*......*............*......*.......
.......*......*............*......*.......
.......*......*............*......*.......
.......********............********.......
