................................********************************................................
...............................*................................*...............................
..............................*..................................*..............................
.............................*....................................*.............................
............................*......................................*............................
...........................*........................................*...........................
..........................*..........................................*..........................
.........................*............................................*.........................
........................*..............................................*........................
.......................*................................................*.......................
......................*..................................................*......................
.....................*....................................................*.....................
....................*......................................................*....................
...................*........................................................*...................
..................*..........................................................*..................
.................*............................................................*.................
*****************..............................................................*****************
*..............................................................................................*
*..............................................................................................*
*..............................................................................................*
*..............................................................................................*
*..............................................................................................*
*..............................................................................................*
*..............................................................................................*
*..............................................................................................*
*..............................................................................................*
*..............................................................................................*
*..............................................................................................*
*..............................................................................................*
*..............................................................................................*
*..............................................................................................*
************************************************************************************************
................*...............*..............................*...............*................
................*...............*..............................*...............*................
................*...............*..............................*...............*................
................*...............*..............................*...............*................
................*...............*..............................*...............*................
................*...............*..............................*...............*................
................*...............*..............................*...............*................
................*...............*..............................*...............*................
................*...............*..............................*...............*................
................*...............*..............................*...............*................
................*...............*..............................*...............*................
................*...............*..............................*...............*................
................*...............*..............................*...............*................
................*...............*..............................*...............*................
................*****************..............................*****************................
