............************............
...........*............*...........
..........*..............*..........
.........*................*.........
........*..................*........
.......*....................*.......
*******......................*******
*..................................*
*..................................*
*..................................*
*..................................*
************************************
......*.....*..........*.....*......
......*.....*..........*.....*......
......*.....*..........*.....*......
......*.....*..........*.....*......
......*******..........*******......
