........................************************........................
.......................*........................*.......................
......................*..........................*......................
.....................*............................*.....................
....................*..............................*....................
...................*................................*...................
..................*..................................*..................
.................*....................................*.................
................*......................................*................
...............*........................................*...............
..............*..........................................*..............
.............*............................................*.............
*************..............................................*************
*......................................................................*
*......................................................................*
*......................................................................*
*......................................................................*
*......................................................................*
*......................................................................*
*......................................................................*
*......................................................................*
*......................................................................*
*......................................................................*
************************************************************************
............*...........*......................*...........*............
............*...........*......................*...........*............
............*...........*......................*...........*............
............*...........*......................*...........*............
............*...........*......................*...........*............
............*...........*......................*...........*............
............*...........*......................*...........*............
............*...........*......................*...........*............
............*...........*......................*...........*............
............*...........*......................*...........*............
............*************......................*************............
