......................**********************......................
.....................*......................*.....................
....................*........................*....................
...................*..........................*...................
..................*............................*..................
.................*..............................*.................
................*................................*................
...............*..................................*...............
..............*....................................*..............
.............*......................................*.............
............*........................................*............
************..........................................************
*................................................................*
*................................................................*
*................................................................*
*................................................................*
*................................................................*
*................................................................*
*................................................................*
*................................................................*
*................................................................*
******************************************************************
...........*..........*....................*..........*...........
...........*..........*....................*..........*...........
...........*..........*....................*..........*...........
...........*..........*....................*..........*...........
...........*..........*....................*..........*...........
...........*..........*....................*..........*...........
...........*..........*....................*..........*...........
...........*..........*....................*..........*...........
...........*..........*....................*..........*...........
...........************....................************...........
