..........................**************************..........................
.........................*..........................*.........................
........................*............................*........................
.......................*..............................*.......................
......................*................................*......................
.....................*..................................*.....................
....................*....................................*....................
...................*......................................*...................
..................*........................................*..................
.................*..........................................*.................
................*............................................*................
...............*..............................................*...............
..............*................................................*..............
**************..................................................**************
*............................................................................*
*............................................................................*
*............................................................................*
*............................................................................*
*............................................................................*
*............................................................................*
*............................................................................*
*............................................................................*
*............................................................................*
*............................................................................*
*............................................................................*
******************************************************************************
.............*............*........................*............*.............
.............*............*........................*............*.............
.............*............*........................*............*.............
.............*............*........................*............*.............
.............*............*........................*............*.............
.............*............*........................*............*.............
.............*............*........................*............*.............
.............*............*........................*............*.............
.............*............*........................*............*.............
.............*............*........................*............*.............
.............*............*........................*............*.............
.............**************........................**************.............
