..............................******************************..............................
.............................*..............................*.............................
............................*................................*............................
...........................*..................................*...........................
..........................*....................................*..........................
.........................*......................................*.........................
........................*........................................*........................
.......................*..........................................*.......................
......................*............................................*......................
.....................*..............................................*.....................
....................*................................................*....................
...................*..................................................*...................
..................*....................................................*..................
.................*......................................................*.................
................*........................................................*................
****************..........................................................****************
*........................................................................................*
*........................................................................................*
*........................................................................................*
*........................................................................................*
*........................................................................................*
*........................................................................................*
*........................................................................................*
*........................................................................................*
*........................................................................................*
*........................................................................................*
*........................................................................................*
*........................................................................................*
*........................................................................................*
******************************************************************************************
...............*..............*............................*..............*...............
...............*..............*............................*..............*...............
...............*..............*............................*..............*...............
...............*..............*............................*..............*...............
...............*..............*............................*..............*...............
...............*..............*............................*..............*...............
...............*..............*............................*..............*...............
...............*..............*............................*..............*...............
...............*..............*............................*..............*...............
...............*..............*............................*..............*...............
...............*..............*............................*..............*...............
...............*..............*............................*..............*...............
...............*..............*............................*..............*...............
...............****************............................****************...............
