........********........
.......*........*.......
......*..........*......
.....*............*.....
*****..............*****
*......................*
*......................*
************************
....*...*......*...*....
....*...*......*...*....
....*****......*****....
