..................................**********************************..................................
.................................*..................................*.................................
................................*....................................*................................
...............................*......................................*...............................
..............................*........................................*..............................
.............................*..........................................*.............................
............................*............................................*............................
...........................*..............................................*...........................
..........................*................................................*..........................
.........................*..................................................*.........................
........................*....................................................*........................
.......................*......................................................*.......................
......................*........................................................*......................
.....................*..........................................................*.....................
....................*............................................................*....................
...................*..............................................................*...................
..................*................................................................*..................
******************..................................................................******************
*....................................................................................................*
*....................................................................................................*
*....................................................................................................*
*....................................................................................................*
*....................................................................................................*
*....................................................................................................*
*....................................................................................................*
*....................................................................................................*
*....................................................................................................*
*....................................................................................................*
*....................................................................................................*
*....................................................................................................*
*....................................................................................................*
*....................................................................................................*
*....................................................................................................*
******************************************************************************************************
.................*................*................................*................*.................
.................*................*................................*................*.................
.................*................*................................*................*.................
.................*................*................................*................*.................
.................*................*................................*................*.................
.................*................*................................*................*.................
.................*................*................................*................*.................
.................*................*................................*................*.................
.................*................*................................*................*.................
.................*................*................................*................*.................
.................*................*................................*................*.................
.................*................*................................*................*.................
.................*................*................................*................*.................
.................*................*................................*................*.................
.................*................*................................*................*.................
.................******************................................******************.................
