................****************................
...............*................*...............
..............*..................*..............
.............*....................*.............
............*......................*............
...........*........................*...........
..........*..........................*..........
.........*............................*.........
*********..............................*********
*..............................................*
*..............................................*
*..............................................*
*..............................................*
*..............................................*
*..............................................*
************************************************
........*.......*..............*.......*........
........*.......*..............*.......*........
........*.......*..............*.......*........
........*.......*..............*.......*........
........*.......*..............*.......*........
........*.......*..............*.......*........
........*********..............*********........
