....................********************....................
...................*....................*...................
..................*......................*..................
.................*........................*.................
................*..........................*................
...............*............................*...............
..............*..............................*..............
.............*................................*.............
............*..................................*............
...........*....................................*...........
***********......................................***********
*..........................................................*
*..........................................................*
*..........................................................*
*..........................................................*
*..........................................................*
*..........................................................*
*..........................................................*
*..........................................................*
************************************************************
..........*.........*..................*.........*..........
..........*.........*..................*.........*..........
..........*.........*..................*.........*..........
..........*.........*..................*.........*..........
..........*.........*..................*.........*..........
..........*.........*..................*.........*..........
..........*.........*..................*.........*..........
..........*.........*..................*.........*..........
..........***********..................***********..........
