......******......
.....*......*.....
....*........*....
****..........****
*................*
******************
...*..*....*..*...
...****....****...
