....................................************************************....................................
...................................*....................................*...................................
..................................*......................................*..................................
.................................*........................................*.................................
................................*..........................................*................................
...............................*............................................*...............................
..............................*..............................................*..............................
.............................*................................................*.............................
............................*..................................................*............................
...........................*....................................................*...........................
..........................*......................................................*..........................
.........................*........................................................*.........................
........................*..........................................................*........................
.......................*............................................................*.......................
......................*..............................................................*......................
.....................*................................................................*.....................
....................*..................................................................*....................
...................*....................................................................*...................
*******************......................................................................*******************
*..........................................................................................................*
*..........................................................................................................*
*..........................................................................................................*
*..........................................................................................................*
*..........................................................................................................*
*..........................................................................................................*
*..........................................................................................................*
*..........................................................................................................*
*..........................................................................................................*
*..........................................................................................................*
*..........................................................................................................*
*..........................................................................................................*
*..........................................................................................................*
*..........................................................................................................*
*..........................................................................................................*
*..........................................................................................................*
************************************************************************************************************
..................*.................*..................................*.................*..................
..................*.................*..................................*.................*..................
..................*.................*..................................*.................*..................
..................*.................*..................................*.................*..................
..................*.................*..................................*.................*..................
..................*.................*..................................*.................*..................
..................*.................*..................................*.................*..................
..................*.................*..................................*.................*..................
..................*.................*..................................*.................*..................
..................*.................*..................................*.................*..................
..................*.................*..................................*.................*..................
..................*.................*..................................*.................*..................
..................*.................*..................................*.................*..................
..................*.................*..................................*.................*..................
..................*.................*..................................*.................*..................
..................*.................*..................................*.................*..................
..................*******************..................................*******************..................
