..........**********..........
.........*..........*.........
........*............*........
.......*..............*.......
......*................*......
******..................******
*............................*
*............................*
*............................*
******************************
.....*....*........*....*.....
.....*....*........*....*.....
.....*....*........*....*.....
.....******........******.....
