..................................*..................................
.................................*.*.................................
................................*...*................................
...............................*.....*...............................
..............................*.......*..............................
.............................*.........*.............................
............................*...........*............................
...........................*.............*...........................
..........................*...............*..........................
.........................*.................*.........................
........................*...................*........................
.......................*.....................*.......................
......................*.......................*......................
.....................*.........................*.....................
....................*...........................*....................
...................*.............................*...................
..................*...............................*..................
******************.................................******************
.*.................................................................*.
..*...............................................................*..
...*.............................................................*...
....*...........................................................*....
.....*.........................................................*.....
......*.......................................................*......
.......*.....................................................*.......
........*...................................................*........
.........*.................................................*.........
..........*...............................................*..........
...........*.............................................*...........
............*...........................................*............
.............*.........................................*.............
..............*.......................................*..............
...............*.....................................*...............
................*...................................*................
.................*................*................*.................
................*................*.*................*................
...............*................*...*................*...............
..............*................*.....*................*..............
.............*................*.......*................*.............
............*................*.........*................*............
...........*................*...........*................*...........
..........*................*.............*................*..........
.........*................*...............*................*.........
........*................*.................*................*........
.......*................*...................*................*.......
......*................*.....................*................*......
.....*................*.......................*................*.....
....*................*.........................*................*....
...*................*...........................*................*...
..*................*.............................*................*..
.*................*...............................*................*.
******************.................................******************
