....................*....................
...................*.*...................
..................*...*..................
.................*.....*.................
................*.......*................
...............*.........*...............
..............*...........*..............
.............*.............*.............
............*...............*............
...........*.................*...........
***********...................***********
.*.....................................*.
..*...................................*..
...*.................................*...
....*...............................*....
.....*.............................*.....
......*...........................*......
.......*.........................*.......
........*.......................*........
.........*.....................*.........
..........*.........*.........*..........
.........*.........*.*.........*.........
........*.........*...*.........*........
.......*.........*.....*.........*.......
......*.........*.......*.........*......
.....*.........*.........*.........*.....
....*.........*...........*.........*....
...*.........*.............*.........*...
..*.........*...............*.........*..
.*.........*.................*.........*.
***********...................***********
