..............................*..............................
.............................*.*.............................
............................*...*............................
...........................*.....*...........................
..........................*.......*..........................
.........................*.........*.........................
........................*...........*........................
.......................*.............*.......................
......................*...............*......................
.....................*.................*.....................
....................*...................*....................
...................*.....................*...................
..................*.......................*..................
.................*.........................*.................
................*...........................*................
****************.............................****************
.*.........................................................*.
..*.......................................................*..
...*.....................................................*...
....*...................................................*....
.....*.................................................*.....
......*...............................................*......
.......*.............................................*.......
........*...........................................*........
.........*.........................................*.........
..........*.......................................*..........
...........*.....................................*...........
............*...................................*............
.............*.................................*.............
..............*...............................*..............
...............*..............*..............*...............
..............*..............*.*..............*..............
.............*..............*...*..............*.............
............*..............*.....*..............*............
...........*..............*.......*..............*...........
..........*..............*.........*..............*..........
.........*..............*...........*..............*.........
........*..............*.............*..............*........
.......*..............*...............*..............*.......
......*..............*.................*..............*......
.....*..............*...................*..............*.....
....*..............*.....................*..............*....
...*..............*.......................*..............*...
..*..............*.........................*..............*..
.*..............*...........................*..............*.
****************.............................****************
