........................*........................
.......................*.*.......................
......................*...*......................
.....................*.....*.....................
....................*.......*....................
...................*.........*...................
..................*...........*..................
.................*.............*.................
................*...............*................
...............*.................*...............
..............*...................*..............
.............*.....................*.............
*************.......................*************
.*.............................................*.
..*...........................................*..
...*.........................................*...
....*.......................................*....
.....*.....................................*.....
......*...................................*......
.......*.................................*.......
........*...............................*........
.........*.............................*.........
..........*...........................*..........
...........*.........................*...........
............*...........*...........*............
...........*...........*.*...........*...........
..........*...........*...*...........*..........
.........*...........*.....*...........*.........
........*...........*.......*...........*........
.......*...........*.........*...........*.......
......*...........*...........*...........*......
.....*...........*.............*...........*.....
....*...........*...............*...........*....
...*...........*.................*...........*...
..*...........*...................*...........*..
.*...........*.....................*...........*.
*************.......................*************
