............................*............................
...........................*.*...........................
..........................*...*..........................
.........................*.....*.........................
........................*.......*........................
.......................*.........*.......................
......................*...........*......................
.....................*.............*.....................
....................*...............*....................
...................*.................*...................
..................*...................*..................
.................*.....................*.................
................*.......................*................
...............*.........................*...............
***************...........................***************
.*.....................................................*.
..*...................................................*..
...*.................................................*...
....*...............................................*....
.....*.............................................*.....
......*...........................................*......
.......*.........................................*.......
........*.......................................*........
.........*.....................................*.........
..........*...................................*..........
...........*.................................*...........
............*...............................*............
.............*.............................*.............
..............*.............*.............*..............
.............*.............*.*.............*.............
............*.............*...*.............*............
...........*.............*.....*.............*...........
..........*.............*.......*.............*..........
.........*.............*.........*.............*.........
........*.............*...........*.............*........
.......*.............*.............*.............*.......
......*.............*...............*.............*......
.....*.............*.................*.............*.....
....*.............*...................*.............*....
...*.............*.....................*.............*...
..*.............*.......................*.............*..
.*.............*.........................*.............*.
***************...........................***************
