................................*................................
...............................*.*...............................
..............................*...*..............................
.............................*.....*.............................
............................*.......*............................
...........................*.........*...........................
..........................*...........*..........................
.........................*.............*.........................
........................*...............*........................
.......................*.................*.......................
......................*...................*......................
.....................*.....................*.....................
....................*.......................*....................
...................*.........................*...................
..................*...........................*..................
.................*.............................*.................
*****************...............................*****************
.*.............................................................*.
..*...........................................................*..
...*.........................................................*...
....*.......................................................*....
.....*.....................................................*.....
......*...................................................*......
.......*.................................................*.......
........*...............................................*........
.........*.............................................*.........
..........*...........................................*..........
...........*.........................................*...........
............*.......................................*............
.............*.....................................*.............
..............*...................................*..............
...............*.................................*...............
................*...............*...............*................
...............*...............*.*...............*...............
..............*...............*...*...............*..............
.............*...............*.....*...............*.............
............*...............*.......*...............*............
...........*...............*.........*...............*...........
..........*...............*...........*...............*..........
.........*...............*.............*...............*.........
........*...............*...............*...............*........
.......*...............*.................*...............*.......
......*...............*...................*...............*......
.....*...............*.....................*...............*.....
....*...............*.......................*...............*....
...*...............*.........................*...............*...
..*...............*...........................*...............*..
.*...............*.............................*...............*.
*****************...............................*****************
