....................................*....................................
...................................*.*...................................
..................................*...*..................................
.................................*.....*.................................
................................*.......*................................
...............................*.........*...............................
..............................*...........*..............................
.............................*.............*.............................
............................*...............*............................
...........................*.................*...........................
..........................*...................*..........................
.........................*.....................*.........................
........................*.......................*........................
.......................*.........................*.......................
......................*...........................*......................
.....................*.............................*.....................
....................*...............................*....................
...................*.................................*...................
*******************...................................*******************
.*.....................................................................*.
..*...................................................................*..
...*.................................................................*...
....*...............................................................*....
.....*.............................................................*.....
......*...........................................................*......
.......*.........................................................*.......
........*.......................................................*........
.........*.....................................................*.........
..........*...................................................*..........
...........*.................................................*...........
............*...............................................*............
.............*.............................................*.............
..............*...........................................*..............
...............*.........................................*...............
................*.......................................*................
.................*.....................................*.................
..................*.................*.................*..................
.................*.................*.*.................*.................
................*.................*...*.................*................
...............*.................*.....*.................*...............
..............*.................*.......*.................*..............
.............*.................*.........*.................*.............
............*.................*...........*.................*............
...........*.................*.............*.................*...........
..........*.................*...............*.................*..........
.........*.................*.................*.................*.........
........*.................*...................*.................*........
.......*.................*.....................*.................*.......
......*.................*.......................*.................*......
.....*.................*.........................*.................*.....
....*.................*...........................*.................*....
...*.................*.............................*.................*...
..*.................*...............................*.................*..
.*.................*.................................*.................*.
*******************...................................*******************
