........*........
.......*.*.......
......*...*......
.....*.....*.....
*****.......*****
.*.............*.
..*...........*..
...*.........*...
....*...*...*....
...*...*.*...*...
..*...*...*...*..
.*...*.....*...*.
*****.......*****
