..........................*..........................
.........................*.*.........................
........................*...*........................
.......................*.....*.......................
......................*.......*......................
.....................*.........*.....................
....................*...........*....................
...................*.............*...................
..................*...............*..................
.................*.................*.................
................*...................*................
...............*.....................*...............
..............*.......................*..............
**************.........................**************
.*.................................................*.
..*...............................................*..
...*.............................................*...
....*...........................................*....
.....*.........................................*.....
......*.......................................*......
.......*.....................................*.......
........*...................................*........
.........*.................................*.........
..........*...............................*..........
...........*.............................*...........
............*...........................*............
.............*............*............*.............
............*............*.*............*............
...........*............*...*............*...........
..........*............*.....*............*..........
.........*............*.......*............*.........
........*............*.........*............*........
.......*............*...........*............*.......
......*............*.............*............*......
.....*............*...............*............*.....
....*............*.................*............*....
...*............*...................*............*...
..*............*.....................*............*..
.*............*.......................*............*.
**************.........................**************
