......*......
.....*.*.....
....*...*....
****.....****
.*.........*.
..*.......*..
...*..*..*...
..*..*.*..*..
.*..*...*..*.
****.....****
