................*................
...............*.*...............
..............*...*..............
.............*.....*.............
............*.......*............
...........*.........*...........
..........*...........*..........
.........*.............*.........
*********...............*********
.*.............................*.
..*...........................*..
...*.........................*...
....*.......................*....
.....*.....................*.....
......*...................*......
.......*.................*.......
........*.......*.......*........
.......*.......*.*.......*.......
......*.......*...*.......*......
.....*.......*.....*.......*.....
....*.......*.......*.......*....
...*.......*.........*.......*...
..*.......*...........*.......*..
.*.......*.............*.......*.
*********...............*********
