..............*..............
.............*.*.............
............*...*............
...........*.....*...........
..........*.......*..........
.........*.........*.........
........*...........*........
********.............********
.*.........................*.
..*.......................*..
...*.....................*...
....*...................*....
.....*.................*.....
......*...............*......
.......*......*......*.......
......*......*.*......*......
.....*......*...*......*.....
....*......*.....*......*....
...*......*.......*......*...
..*......*.........*......*..
.*......*...........*......*.
********.............********
