..........*..........
.........*.*.........
........*...*........
.......*.....*.......
......*.......*......
******.........******
.*.................*.
..*...............*..
...*.............*...
....*...........*....
.....*....*....*.....
....*....*.*....*....
...*....*...*....*...
..*....*.....*....*..
.*....*.......*....*.
******.........******
