..................*..................
.................*.*.................
................*...*................
...............*.....*...............
..............*.......*..............
.............*.........*.............
............*...........*............
...........*.............*...........
..........*...............*..........
**********.................**********
.*.................................*.
..*...............................*..
...*.............................*...
....*...........................*....
.....*.........................*.....
......*.......................*......
.......*.....................*.......
........*...................*........
.........*........*........*.........
........*........*.*........*........
.......*........*...*........*.......
......*........*.....*........*......
.....*........*.......*........*.....
....*........*.........*........*....
...*........*...........*........*...
..*........*.............*........*..
.*........*...............*........*.
**********.................**********
