......................*......................
.....................*.*.....................
....................*...*....................
...................*.....*...................
..................*.......*..................
.................*.........*.................
................*...........*................
...............*.............*...............
..............*...............*..............
.............*.................*.............
............*...................*............
************.....................************
.*.........................................*.
..*.......................................*..
...*.....................................*...
....*...................................*....
.....*.................................*.....
......*...............................*......
.......*.............................*.......
........*...........................*........
.........*.........................*.........
..........*.......................*..........
...........*..........*..........*...........
..........*..........*.*..........*..........
.........*..........*...*..........*.........
........*..........*.....*..........*........
.......*..........*.......*..........*.......
......*..........*.........*..........*......
.....*..........*...........*..........*.....
....*..........*.............*..........*....
...*..........*...............*..........*...
..*..........*.................*..........*..
.*..........*...................*..........*.
************.....................************
