............*............
...........*.*...........
..........*...*..........
.........*.....*.........
........*.......*........
.......*.........*.......
*******...........*******
.*.....................*.
..*...................*..
...*.................*...
....*...............*....
.....*.............*.....
......*.....*.....*......
.....*.....*.*.....*.....
....*.....*...*.....*....
...*.....*.....*.....*...
..*.....*.......*.....*..
.*.....*.........*.....*.
*******...........*******
